"filename", "language", "Dart", "comment", "blank", "total"
"d:\Flutter Application\book_store_manager\lib\constant\app_fonts.dart", "Dart", 4, 0, 1, 5
"d:\Flutter Application\book_store_manager\lib\constant\app_icons.dart", "Dart", 18, 0, 2, 20
"d:\Flutter Application\book_store_manager\lib\constant\app_images.dart", "Dart", 10, 0, 3, 13
"d:\Flutter Application\book_store_manager\lib\constant\data_collections.dart", "Dart", 8, 0, 1, 9
"d:\Flutter Application\book_store_manager\lib\constant\data_document.dart", "Dart", 5, 0, 1, 6
"d:\Flutter Application\book_store_manager\lib\constant\enum.dart", "Dart", 3, 0, 3, 6
"d:\Flutter Application\book_store_manager\lib\extensions\datetime_ex.dart", "Dart", 14, 0, 3, 17
"d:\Flutter Application\book_store_manager\lib\firebase_options.dart", "Dart", 55, 12, 4, 71
"d:\Flutter Application\book_store_manager\lib\main.dart", "Dart", 39, 0, 6, 45
"d:\Flutter Application\book_store_manager\lib\models\book_type_model.dart", "Dart", 35, 0, 5, 40
"d:\Flutter Application\book_store_manager\lib\models\home_statistic_model.dart", "Dart", 21, 0, 4, 25
"d:\Flutter Application\book_store_manager\lib\models\import_product_model.dart", "Dart", 11, 0, 3, 14
"d:\Flutter Application\book_store_manager\lib\models\order_model.dart", "Dart", 62, 0, 8, 70
"d:\Flutter Application\book_store_manager\lib\models\order_product_model.dart", "Dart", 28, 0, 4, 32
"d:\Flutter Application\book_store_manager\lib\models\product_create_model.dart", "Dart", 32, 0, 3, 35
"d:\Flutter Application\book_store_manager\lib\models\product_model.dart", "Dart", 76, 0, 10, 86
"d:\Flutter Application\book_store_manager\lib\models\user_model.dart", "Dart", 27, 0, 4, 31
"d:\Flutter Application\book_store_manager\lib\repositories\import_repository.dart", "Dart", 24, 0, 8, 32
"d:\Flutter Application\book_store_manager\lib\repositories\order_repository.dart", "Dart", 52, 0, 17, 69
"d:\Flutter Application\book_store_manager\lib\repositories\product_repository.dart", "Dart", 48, 0, 11, 59
"d:\Flutter Application\book_store_manager\lib\repositories\repository.dart", "Dart", 16, 0, 4, 20
"d:\Flutter Application\book_store_manager\lib\repositories\services\admin_account_service.dart", "Dart", 12, 0, 4, 16
"d:\Flutter Application\book_store_manager\lib\repositories\services\authentication_service.dart", "Dart", 13, 0, 4, 17
"d:\Flutter Application\book_store_manager\lib\repositories\services\import_service.dart", "Dart", 74, 0, 14, 88
"d:\Flutter Application\book_store_manager\lib\repositories\services\order_service.dart", "Dart", 145, 0, 28, 173
"d:\Flutter Application\book_store_manager\lib\repositories\services\product_service.dart", "Dart", 110, 0, 26, 136
"d:\Flutter Application\book_store_manager\lib\repositories\services\transaction_service.dart", "Dart", 23, 0, 3, 26
"d:\Flutter Application\book_store_manager\lib\repositories\services\user_service.dart", "Dart", 75, 0, 13, 88
"d:\Flutter Application\book_store_manager\lib\repositories\user_repository.dart", "Dart", 28, 0, 10, 38
"d:\Flutter Application\book_store_manager\lib\screens\home\bloc\home_bloc.dart", "Dart", 18, 0, 7, 25
"d:\Flutter Application\book_store_manager\lib\screens\home\bloc\home_event.dart", "Dart", 7, 0, 4, 11
"d:\Flutter Application\book_store_manager\lib\screens\home\bloc\home_state.dart", "Dart", 20, 0, 5, 25
"d:\Flutter Application\book_store_manager\lib\screens\home\home_page.dart", "Dart", 191, 0, 3, 194
"d:\Flutter Application\book_store_manager\lib\screens\home\views\home_background.dart", "Dart", 22, 0, 4, 26
"d:\Flutter Application\book_store_manager\lib\screens\home\views\home_cell.dart", "Dart", 71, 0, 4, 75
"d:\Flutter Application\book_store_manager\lib\screens\home\views\home_drawer.dart", "Dart", 63, 0, 4, 67
"d:\Flutter Application\book_store_manager\lib\screens\home\views\home_statistic.dart", "Dart", 60, 0, 5, 65
"d:\Flutter Application\book_store_manager\lib\screens\home\views\home_tile.dart", "Dart", 54, 1, 4, 59
"d:\Flutter Application\book_store_manager\lib\screens\home\views\statistic_item.dart", "Dart", 66, 0, 4, 70
"d:\Flutter Application\book_store_manager\lib\screens\import_product\bloc\import_product_bloc.dart", "Dart", 56, 0, 13, 69
"d:\Flutter Application\book_store_manager\lib\screens\import_product\bloc\import_product_event.dart", "Dart", 14, 0, 7, 21
"d:\Flutter Application\book_store_manager\lib\screens\import_product\bloc\import_product_state.dart", "Dart", 24, 0, 5, 29
"d:\Flutter Application\book_store_manager\lib\screens\import_product\import_product_page.dart", "Dart", 116, 0, 6, 122
"d:\Flutter Application\book_store_manager\lib\screens\import_product\views\calendar_button.dart", "Dart", 72, 0, 4, 76
"d:\Flutter Application\book_store_manager\lib\screens\import_product\views\import_history_item.dart", "Dart", 132, 0, 6, 138
"d:\Flutter Application\book_store_manager\lib\screens\import_product_create\bloc\create_import_product_bloc.dart", "Dart", 64, 0, 14, 78
"d:\Flutter Application\book_store_manager\lib\screens\import_product_create\bloc\create_import_product_event.dart", "Dart", 24, 0, 11, 35
"d:\Flutter Application\book_store_manager\lib\screens\import_product_create\bloc\create_import_product_state.dart", "Dart", 25, 0, 6, 31
"d:\Flutter Application\book_store_manager\lib\screens\import_product_create\create_import_product_page.dart", "Dart", 208, 0, 8, 216
"d:\Flutter Application\book_store_manager\lib\screens\import_product_create\views\create_import_item.dart", "Dart", 160, 0, 8, 168
"d:\Flutter Application\book_store_manager\lib\screens\import_product_create\views\dialog_item.dart", "Dart", 61, 0, 5, 66
"d:\Flutter Application\book_store_manager\lib\screens\import_product_create\views\product_picker_dialog.dart", "Dart", 104, 0, 7, 111
"d:\Flutter Application\book_store_manager\lib\screens\login\bloc\login_bloc.dart", "Dart", 53, 0, 11, 64
"d:\Flutter Application\book_store_manager\lib\screens\login\bloc\login_event.dart", "Dart", 11, 0, 7, 18
"d:\Flutter Application\book_store_manager\lib\screens\login\bloc\login_state.dart", "Dart", 30, 0, 4, 34
"d:\Flutter Application\book_store_manager\lib\screens\login\login_page.dart", "Dart", 119, 0, 4, 123
"d:\Flutter Application\book_store_manager\lib\screens\login\views\login_button.dart", "Dart", 46, 0, 4, 50
"d:\Flutter Application\book_store_manager\lib\screens\login\views\password_tf.dart", "Dart", 59, 0, 7, 66
"d:\Flutter Application\book_store_manager\lib\screens\login\views\styles.dart", "Dart", 7, 0, 2, 9
"d:\Flutter Application\book_store_manager\lib\screens\login\views\username_tf.dart", "Dart", 45, 0, 6, 51
"d:\Flutter Application\book_store_manager\lib\screens\manage_feedback\manage_feedback_page.dart", "Dart", 16, 0, 3, 19
"d:\Flutter Application\book_store_manager\lib\screens\manage_order\bloc\manage_order_bloc.dart", "Dart", 118, 19, 24, 161
"d:\Flutter Application\book_store_manager\lib\screens\manage_order\bloc\manage_order_event.dart", "Dart", 19, 0, 10, 29
"d:\Flutter Application\book_store_manager\lib\screens\manage_order\bloc\manage_order_state.dart", "Dart", 36, 0, 5, 41
"d:\Flutter Application\book_store_manager\lib\screens\manage_order\manage_order_page.dart", "Dart", 171, 1, 7, 179
"d:\Flutter Application\book_store_manager\lib\screens\manage_order\views\basic_orders.dart", "Dart", 27, 0, 6, 33
"d:\Flutter Application\book_store_manager\lib\screens\manage_order\views\express_orders.dart", "Dart", 27, 0, 7, 34
"d:\Flutter Application\book_store_manager\lib\screens\manage_order\views\fast_orders.dart", "Dart", 27, 0, 6, 33
"d:\Flutter Application\book_store_manager\lib\screens\manage_order\views\order_status_item.dart", "Dart", 51, 0, 4, 55
"d:\Flutter Application\book_store_manager\lib\screens\manage_order\views\order_tab_bar.dart", "Dart", 98, 0, 5, 103
"d:\Flutter Application\book_store_manager\lib\screens\manage_order\views\orders_list.dart", "Dart", 34, 0, 4, 38
"d:\Flutter Application\book_store_manager\lib\screens\manage_order\views\sort_dropdown_button.dart", "Dart", 93, 0, 3, 96
"d:\Flutter Application\book_store_manager\lib\screens\manage_product\bloc\manage_product_bloc.dart", "Dart", 101, 0, 22, 123
"d:\Flutter Application\book_store_manager\lib\screens\manage_product\bloc\manage_product_event.dart", "Dart", 19, 0, 8, 27
"d:\Flutter Application\book_store_manager\lib\screens\manage_product\bloc\manage_product_state.dart", "Dart", 45, 0, 5, 50
"d:\Flutter Application\book_store_manager\lib\screens\manage_product\manage_product_page.dart", "Dart", 122, 0, 8, 130
"d:\Flutter Application\book_store_manager\lib\screens\manage_product\views\filter_product_dialog.dart", "Dart", 317, 0, 8, 325
"d:\Flutter Application\book_store_manager\lib\screens\manage_product\views\product_item.dart", "Dart", 115, 0, 5, 120
"d:\Flutter Application\book_store_manager\lib\screens\manage_product\views\product_list.dart", "Dart", 82, 0, 3, 85
"d:\Flutter Application\book_store_manager\lib\screens\manage_product\views\search_field.dart", "Dart", 80, 0, 7, 87
"d:\Flutter Application\book_store_manager\lib\screens\manage_product\views\styles.dart", "Dart", 5, 0, 2, 7
"d:\Flutter Application\book_store_manager\lib\screens\manage_product\views\total_product.dart", "Dart", 28, 0, 3, 31
"d:\Flutter Application\book_store_manager\lib\screens\manage_user\bloc\manage_user_bloc.dart", "Dart", 39, 0, 10, 49
"d:\Flutter Application\book_store_manager\lib\screens\manage_user\bloc\manage_user_event.dart", "Dart", 11, 0, 6, 17
"d:\Flutter Application\book_store_manager\lib\screens\manage_user\bloc\manage_user_state.dart", "Dart", 24, 0, 5, 29
"d:\Flutter Application\book_store_manager\lib\screens\manage_user\manage_user_page.dart", "Dart", 41, 0, 3, 44
"d:\Flutter Application\book_store_manager\lib\screens\manage_user\views\styles.dart", "Dart", 5, 0, 2, 7
"d:\Flutter Application\book_store_manager\lib\screens\manage_user\views\total_user.dart", "Dart", 24, 0, 3, 27
"d:\Flutter Application\book_store_manager\lib\screens\manage_user\views\user_item.dart", "Dart", 80, 0, 5, 85
"d:\Flutter Application\book_store_manager\lib\screens\manage_user\views\user_list.dart", "Dart", 85, 0, 7, 92
"d:\Flutter Application\book_store_manager\lib\screens\manage_user\views\user_search_field.dart", "Dart", 81, 0, 8, 89
"d:\Flutter Application\book_store_manager\lib\screens\order_details\bloc\order_details_bloc.dart", "Dart", 78, 0, 13, 91
"d:\Flutter Application\book_store_manager\lib\screens\order_details\bloc\order_details_event.dart", "Dart", 30, 0, 15, 45
"d:\Flutter Application\book_store_manager\lib\screens\order_details\bloc\order_details_state.dart", "Dart", 20, 0, 5, 25
"d:\Flutter Application\book_store_manager\lib\screens\order_details\order_details_page.dart", "Dart", 293, 0, 15, 308
"d:\Flutter Application\book_store_manager\lib\screens\order_details\views\confirm_button.dart", "Dart", 159, 0, 5, 164
"d:\Flutter Application\book_store_manager\lib\screens\order_details\views\deliver_button.dart", "Dart", 64, 0, 4, 68
"d:\Flutter Application\book_store_manager\lib\screens\order_details\views\order_status.dart", "Dart", 42, 0, 4, 46
"d:\Flutter Application\book_store_manager\lib\screens\order_details\views\prepare_button.dart", "Dart", 64, 0, 4, 68
"d:\Flutter Application\book_store_manager\lib\screens\order_details\views\product_item.dart", "Dart", 76, 5, 5, 86
"d:\Flutter Application\book_store_manager\lib\screens\order_details\views\row_info.dart", "Dart", 33, 0, 4, 37
"d:\Flutter Application\book_store_manager\lib\screens\order_details\views\row_info_space.dart", "Dart", 45, 0, 4, 49
"d:\Flutter Application\book_store_manager\lib\screens\order_done\bloc\order_done_bloc.dart", "Dart", 122, 0, 25, 147
"d:\Flutter Application\book_store_manager\lib\screens\order_done\bloc\order_done_event.dart", "Dart", 19, 0, 10, 29
"d:\Flutter Application\book_store_manager\lib\screens\order_done\bloc\order_done_state.dart", "Dart", 45, 0, 5, 50
"d:\Flutter Application\book_store_manager\lib\screens\order_done\order_done_page.dart", "Dart", 215, 0, 6, 221
"d:\Flutter Application\book_store_manager\lib\screens\order_done\views\calendar_button.dart", "Dart", 79, 0, 5, 84
"d:\Flutter Application\book_store_manager\lib\screens\order_done\views\filter_button.dart", "Dart", 107, 1, 5, 113
"d:\Flutter Application\book_store_manager\lib\screens\order_done\views\indicator.dart", "Dart", 41, 0, 4, 45
"d:\Flutter Application\book_store_manager\lib\screens\order_done\views\order_creator.dart", "Dart", 12, 0, 3, 15
"d:\Flutter Application\book_store_manager\lib\screens\order_done\views\order_list.dart", "Dart", 41, 0, 7, 48
"d:\Flutter Application\book_store_manager\lib\screens\order_done\views\search_order_field.dart", "Dart", 76, 0, 8, 84
"d:\Flutter Application\book_store_manager\lib\screens\order_status\delivering\bloc\delivering_order_bloc.dart", "Dart", 61, 19, 17, 97
"d:\Flutter Application\book_store_manager\lib\screens\order_status\delivering\bloc\delivering_order_event.dart", "Dart", 11, 0, 6, 17
"d:\Flutter Application\book_store_manager\lib\screens\order_status\delivering\bloc\delivering_order_state.dart", "Dart", 20, 0, 5, 25
"d:\Flutter Application\book_store_manager\lib\screens\order_status\delivering\order_delivering_page.dart", "Dart", 42, 0, 7, 49
"d:\Flutter Application\book_store_manager\lib\screens\order_status\order_status_page.dart", "Dart", 130, 0, 10, 140
"d:\Flutter Application\book_store_manager\lib\screens\order_status\prepared\bloc\prepared_order_bloc.dart", "Dart", 73, 19, 18, 110
"d:\Flutter Application\book_store_manager\lib\screens\order_status\prepared\bloc\prepared_order_event.dart", "Dart", 15, 0, 8, 23
"d:\Flutter Application\book_store_manager\lib\screens\order_status\prepared\bloc\prepared_order_state.dart", "Dart", 20, 0, 5, 25
"d:\Flutter Application\book_store_manager\lib\screens\order_status\prepared\order_prepared_page.dart", "Dart", 49, 0, 6, 55
"d:\Flutter Application\book_store_manager\lib\screens\order_status\preparing\bloc\preparing_order_bloc.dart", "Dart", 75, 19, 18, 112
"d:\Flutter Application\book_store_manager\lib\screens\order_status\preparing\bloc\preparing_order_event.dart", "Dart", 15, 0, 8, 23
"d:\Flutter Application\book_store_manager\lib\screens\order_status\preparing\bloc\preparing_order_state.dart", "Dart", 20, 0, 5, 25
"d:\Flutter Application\book_store_manager\lib\screens\order_status\preparing\order_preparing_page.dart", "Dart", 49, 0, 6, 55
"d:\Flutter Application\book_store_manager\lib\screens\order_status\views\order_status_tab.dart", "Dart", 16, 0, 4, 20
"d:\Flutter Application\book_store_manager\lib\screens\product_create\bloc\create_product_bloc.dart", "Dart", 124, 0, 30, 154
"d:\Flutter Application\book_store_manager\lib\screens\product_create\bloc\create_product_event.dart", "Dart", 47, 0, 24, 71
"d:\Flutter Application\book_store_manager\lib\screens\product_create\bloc\create_product_state.dart", "Dart", 94, 0, 6, 100
"d:\Flutter Application\book_store_manager\lib\screens\product_create\create_product_page.dart", "Dart", 322, 0, 7, 329
"d:\Flutter Application\book_store_manager\lib\screens\product_create\views\booktype_selector.dart", "Dart", 81, 0, 4, 85
"d:\Flutter Application\book_store_manager\lib\screens\product_create\views\custom_textfield.dart", "Dart", 76, 0, 6, 82
"d:\Flutter Application\book_store_manager\lib\screens\product_create\views\images_grid.dart", "Dart", 119, 0, 9, 128
"d:\Flutter Application\book_store_manager\lib\screens\product_create\views\publishing_year_selector.dart", "Dart", 78, 0, 4, 82
"d:\Flutter Application\book_store_manager\lib\screens\product_create\views\textfield_title.dart", "Dart", 26, 0, 4, 30
"d:\Flutter Application\book_store_manager\lib\screens\product_detail\bloc\product_detail_bloc.dart", "Dart", 39, 0, 10, 49
"d:\Flutter Application\book_store_manager\lib\screens\product_detail\bloc\product_detail_event.dart", "Dart", 22, 0, 7, 29
"d:\Flutter Application\book_store_manager\lib\screens\product_detail\bloc\product_detail_state.dart", "Dart", 24, 0, 5, 29
"d:\Flutter Application\book_store_manager\lib\screens\product_detail\photo_gallery_view.dart", "Dart", 73, 0, 8, 81
"d:\Flutter Application\book_store_manager\lib\screens\product_detail\product_detail_page.dart", "Dart", 124, 0, 8, 132
"d:\Flutter Application\book_store_manager\lib\screens\product_detail\views\image_product.dart", "Dart", 76, 0, 6, 82
"d:\Flutter Application\book_store_manager\lib\screens\product_detail\views\orther_information_product.dart", "Dart", 134, 0, 7, 141
"d:\Flutter Application\book_store_manager\lib\screens\product_detail\views\overview_product.dart", "Dart", 170, 0, 5, 175
"d:\Flutter Application\book_store_manager\lib\screens\product_detail\views\row_data.dart", "Dart", 39, 0, 4, 43
"d:\Flutter Application\book_store_manager\lib\screens\product_detail\views\styles.dart", "Dart", 12, 0, 3, 15
"d:\Flutter Application\book_store_manager\lib\screens\product_detail\views\update_orther_infor_dialog.dart", "Dart", 239, 0, 12, 251
"d:\Flutter Application\book_store_manager\lib\screens\product_edit_overview\bloc\product_edit_overview_bloc.dart", "Dart", 100, 0, 20, 120
"d:\Flutter Application\book_store_manager\lib\screens\product_edit_overview\bloc\product_edit_overview_event.dart", "Dart", 35, 0, 18, 53
"d:\Flutter Application\book_store_manager\lib\screens\product_edit_overview\bloc\product_edit_overview_state.dart", "Dart", 74, 0, 7, 81
"d:\Flutter Application\book_store_manager\lib\screens\product_edit_overview\edit_overview_product_page.dart", "Dart", 304, 0, 16, 320
"d:\Flutter Application\book_store_manager\lib\screens\product_edit_overview\views\booktype_selector.dart", "Dart", 79, 0, 3, 82
"d:\Flutter Application\book_store_manager\lib\screens\product_edit_overview\views\confirm_update_button.dart", "Dart", 95, 0, 7, 102
"d:\Flutter Application\book_store_manager\lib\screens\product_edit_overview\views\year_selector_textfield.dart", "Dart", 77, 0, 9, 86
"d:\Flutter Application\book_store_manager\lib\screens\root\bloc\root_bloc.dart", "Dart", 28, 0, 8, 36
"d:\Flutter Application\book_store_manager\lib\screens\root\bloc\root_event.dart", "Dart", 7, 0, 5, 12
"d:\Flutter Application\book_store_manager\lib\screens\root\bloc\root_state.dart", "Dart", 15, 0, 4, 19
"d:\Flutter Application\book_store_manager\lib\screens\root\require_sign_out_page.dart", "Dart", 78, 0, 3, 81
"d:\Flutter Application\book_store_manager\lib\screens\root\root_page.dart", "Dart", 51, 0, 8, 59
"d:\Flutter Application\book_store_manager\lib\screens\user_details\bloc\user_details_bloc.dart", "Dart", 117, 26, 27, 170
"d:\Flutter Application\book_store_manager\lib\screens\user_details\bloc\user_details_event.dart", "Dart", 32, 0, 13, 45
"d:\Flutter Application\book_store_manager\lib\screens\user_details\bloc\user_details_state.dart", "Dart", 28, 0, 5, 33
"d:\Flutter Application\book_store_manager\lib\screens\user_details\user_details_page.dart", "Dart", 188, 1, 5, 194
"d:\Flutter Application\book_store_manager\lib\screens\user_details\views\user_information.dart", "Dart", 74, 0, 3, 77
"d:\Flutter Application\book_store_manager\lib\screens\user_details\views\user_order_item_creator.dart", "Dart", 46, 0, 2, 48
"d:\Flutter Application\book_store_manager\lib\screens\user_details\views\user_orders_list.dart", "Dart", 44, 0, 6, 50
"d:\Flutter Application\book_store_manager\lib\screens\user_details\views\user_statistic_item.dart", "Dart", 32, 0, 4, 36
"d:\Flutter Application\book_store_manager\lib\screens\user_order_history\bloc\user_order_history_bloc.dart", "Dart", 73, 0, 13, 86
"d:\Flutter Application\book_store_manager\lib\screens\user_order_history\bloc\user_order_history_event.dart", "Dart", 14, 0, 7, 21
"d:\Flutter Application\book_store_manager\lib\screens\user_order_history\bloc\user_order_history_state.dart", "Dart", 53, 0, 7, 60
"d:\Flutter Application\book_store_manager\lib\screens\user_order_history\user_order_history_page.dart", "Dart", 307, 1, 11, 319
"d:\Flutter Application\book_store_manager\lib\screens\user_order_history\views\filter_button.dart", "Dart", 110, 1, 4, 115
"d:\Flutter Application\book_store_manager\lib\screens\user_order_history\views\order_creator.dart", "Dart", 12, 0, 3, 15
"d:\Flutter Application\book_store_manager\lib\screens\user_order_history\views\order_history_list.dart", "Dart", 40, 0, 6, 46
"d:\Flutter Application\book_store_manager\lib\screens\user_order_history\views\statistic_1.dart", "Dart", 40, 0, 4, 44
"d:\Flutter Application\book_store_manager\lib\screens\user_order_history\views\statistic_item.dart", "Dart", 37, 0, 4, 41
"d:\Flutter Application\book_store_manager\lib\themes\colors.dart", "Dart", 11, 0, 3, 14
"d:\Flutter Application\book_store_manager\lib\themes\texts.dart", "Dart", 23, 0, 5, 28
"d:\Flutter Application\book_store_manager\lib\utils\converter.dart", "Dart", 56, 0, 6, 62
"d:\Flutter Application\book_store_manager\lib\utils\currency_utils.dart", "Dart", 22, 0, 4, 26
"d:\Flutter Application\book_store_manager\lib\utils\date_time.dart", "Dart", 27, 0, 8, 35
"d:\Flutter Application\book_store_manager\lib\utils\dialog_utils.dart", "Dart", 27, 0, 6, 33
"d:\Flutter Application\book_store_manager\lib\utils\email_validator.dart", "Dart", 6, 0, 2, 8
"d:\Flutter Application\book_store_manager\lib\utils\number_utils.dart", "Dart", 12, 0, 1, 13
"d:\Flutter Application\book_store_manager\lib\widgets\abstract\abstract_order_item.dart", "Dart", 223, 0, 9, 232
"d:\Flutter Application\book_store_manager\lib\widgets\abstract\await_confirm_order_item.dart", "Dart", 74, 0, 5, 79
"d:\Flutter Application\book_store_manager\lib\widgets\abstract\cancel_order_item.dart", "Dart", 48, 0, 6, 54
"d:\Flutter Application\book_store_manager\lib\widgets\abstract\complete_order_item.dart", "Dart", 48, 0, 6, 54
"d:\Flutter Application\book_store_manager\lib\widgets\abstract\delivering_order_item.dart", "Dart", 39, 0, 4, 43
"d:\Flutter Application\book_store_manager\lib\widgets\abstract\prepared_order_item.dart", "Dart", 74, 0, 5, 79
"d:\Flutter Application\book_store_manager\lib\widgets\abstract\preparing_order_item.dart", "Dart", 74, 0, 5, 79
"d:\Flutter Application\book_store_manager\lib\widgets\custom_app_bar.dart", "Dart", 44, 0, 5, 49
"d:\Flutter Application\book_store_manager\lib\widgets\data_form.dart", "Dart", 21, 0, 4, 25
"d:\Flutter Application\book_store_manager\lib\widgets\dialogs\confirm_dialog.dart", "Dart", 106, 0, 4, 110
"d:\Flutter Application\book_store_manager\lib\widgets\dialogs\loading_dialog.dart", "Dart", 28, 0, 3, 31
"d:\Flutter Application\book_store_manager\lib\widgets\dialogs\pick_image_option_dialog.dart", "Dart", 67, 18, 4, 89
"d:\Flutter Application\book_store_manager\lib\widgets\dialogs\warning_dialog.dart", "Dart", 66, 0, 5, 71
"d:\Flutter Application\book_store_manager\lib\widgets\empty_import_list.dart", "Dart", 34, 0, 3, 37
"d:\Flutter Application\book_store_manager\lib\widgets\empty_orders_list.dart", "Dart", 34, 0, 3, 37
"d:\Flutter Application\book_store_manager\lib\widgets\flag_cllip_path.dart", "Dart", 17, 0, 5, 22
"d:\Flutter Application\book_store_manager\lib\widgets\loading\home_loading_page.dart", "Dart", 17, 0, 3, 20
"d:\Flutter Application\book_store_manager\lib\widgets\loading\loading_list.dart", "Dart", 18, 0, 4, 22
"d:\Flutter Application\book_store_manager\lib\widgets\month_picker.dart", "Dart", 99, 0, 9, 108
"d:\Flutter Application\book_store_manager\lib\widgets\page_route_transition.dart", "Dart", 18, 0, 4, 22
"d:\Flutter Application\book_store_manager\lib\widgets\title.dart", "Dart", 18, 0, 4, 22
"d:\Flutter Application\book_store_manager\lib\widgets\year_picker.dart", "Dart", 103, 0, 10, 113
"Total", "-", 12911, 143, 1425, 14479